"filename", "language", "YAML", "XML", "C++", "comment", "blank", "total"
"/home/mingrui/Mingrui/learning/arm_planning/ws_catkin/src/arm_planning/app/test_1.cpp", "C++", 0, 0, 42, 6, 24, 72
"/home/mingrui/Mingrui/learning/arm_planning/ws_catkin/src/arm_planning/app/test_2.cpp", "C++", 0, 0, 101, 15, 25, 141
"/home/mingrui/Mingrui/learning/arm_planning/ws_catkin/src/arm_planning/app/test_3.cpp", "C++", 0, 0, 108, 15, 23, 146
"/home/mingrui/Mingrui/learning/arm_planning/ws_catkin/src/arm_planning/app/test_4.cpp", "C++", 0, 0, 108, 17, 23, 148
"/home/mingrui/Mingrui/learning/arm_planning/ws_catkin/src/arm_planning/config/panda_configs.yaml", "YAML", 11, 0, 0, 0, 2, 13
"/home/mingrui/Mingrui/learning/arm_planning/ws_catkin/src/arm_planning/config/planner_configs.yaml", "YAML", 65, 0, 0, 1, 6, 72
"/home/mingrui/Mingrui/learning/arm_planning/ws_catkin/src/arm_planning/include/arm_planning/common_include.h", "C++", 0, 0, 37, 5, 10, 52
"/home/mingrui/Mingrui/learning/arm_planning/ws_catkin/src/arm_planning/include/arm_planning/node.h", "C++", 0, 0, 19, 0, 11, 30
"/home/mingrui/Mingrui/learning/arm_planning/ws_catkin/src/arm_planning/include/arm_planning/planner/atace.h", "C++", 0, 0, 45, 1, 19, 65
"/home/mingrui/Mingrui/learning/arm_planning/ws_catkin/src/arm_planning/include/arm_planning/planner/cbirrt.h", "C++", 0, 0, 46, 0, 20, 66
"/home/mingrui/Mingrui/learning/arm_planning/ws_catkin/src/arm_planning/include/arm_planning/planner/ik_rrt.h", "C++", 0, 0, 34, 0, 17, 51
"/home/mingrui/Mingrui/learning/arm_planning/ws_catkin/src/arm_planning/include/arm_planning/planner/jt_rrt.h", "C++", 0, 0, 47, 1, 19, 67
"/home/mingrui/Mingrui/learning/arm_planning/ws_catkin/src/arm_planning/include/arm_planning/planner/planner_base.h", "C++", 0, 0, 109, 1, 41, 151
"/home/mingrui/Mingrui/learning/arm_planning/ws_catkin/src/arm_planning/include/arm_planning/planner/rrt.h", "C++", 0, 0, 30, 1, 17, 48
"/home/mingrui/Mingrui/learning/arm_planning/ws_catkin/src/arm_planning/include/arm_planning/planner/rrt_connect.h", "C++", 0, 0, 29, 0, 15, 44
"/home/mingrui/Mingrui/learning/arm_planning/ws_catkin/src/arm_planning/include/arm_planning/planning_interface.h", "C++", 0, 0, 32, 0, 24, 56
"/home/mingrui/Mingrui/learning/arm_planning/ws_catkin/src/arm_planning/include/arm_planning/planning_request.h", "C++", 0, 0, 20, 0, 11, 31
"/home/mingrui/Mingrui/learning/arm_planning/ws_catkin/src/arm_planning/include/arm_planning/planning_response.h", "C++", 0, 0, 16, 0, 10, 26
"/home/mingrui/Mingrui/learning/arm_planning/ws_catkin/src/arm_planning/include/arm_planning/robot.h", "C++", 0, 0, 100, 10, 38, 148
"/home/mingrui/Mingrui/learning/arm_planning/ws_catkin/src/arm_planning/include/arm_planning/scene.h", "C++", 0, 0, 29, 5, 21, 55
"/home/mingrui/Mingrui/learning/arm_planning/ws_catkin/src/arm_planning/include/arm_planning/visualize.h", "C++", 0, 0, 43, 3, 22, 68
"/home/mingrui/Mingrui/learning/arm_planning/ws_catkin/src/arm_planning/include/utils/ros_utils.h", "C++", 0, 0, 42, 2, 17, 61
"/home/mingrui/Mingrui/learning/arm_planning/ws_catkin/src/arm_planning/include/utils/utils.h", "C++", 0, 0, 214, 26, 62, 302
"/home/mingrui/Mingrui/learning/arm_planning/ws_catkin/src/arm_planning/launch/panda_sim_prepare.launch", "XML", 0, 11, 0, 0, 7, 18
"/home/mingrui/Mingrui/learning/arm_planning/ws_catkin/src/arm_planning/package.xml", "XML", 0, 47, 0, 36, 13, 96
"/home/mingrui/Mingrui/learning/arm_planning/ws_catkin/src/arm_planning/src/planner/atace.cpp", "C++", 0, 0, 229, 21, 78, 328
"/home/mingrui/Mingrui/learning/arm_planning/ws_catkin/src/arm_planning/src/planner/cbirrt.cpp", "C++", 0, 0, 243, 14, 80, 337
"/home/mingrui/Mingrui/learning/arm_planning/ws_catkin/src/arm_planning/src/planner/ik_rrt.cpp", "C++", 0, 0, 157, 6, 55, 218
"/home/mingrui/Mingrui/learning/arm_planning/ws_catkin/src/arm_planning/src/planner/jt_rrt.cpp", "C++", 0, 0, 226, 12, 81, 319
"/home/mingrui/Mingrui/learning/arm_planning/ws_catkin/src/arm_planning/src/planner/planner_base.cpp", "C++", 0, 0, 292, 29, 101, 422
"/home/mingrui/Mingrui/learning/arm_planning/ws_catkin/src/arm_planning/src/planner/rrt.cpp", "C++", 0, 0, 121, 5, 46, 172
"/home/mingrui/Mingrui/learning/arm_planning/ws_catkin/src/arm_planning/src/planner/rrt_connect.cpp", "C++", 0, 0, 136, 5, 50, 191
"/home/mingrui/Mingrui/learning/arm_planning/ws_catkin/src/arm_planning/src/planning_interface.cpp", "C++", 0, 0, 66, 4, 23, 93
"/home/mingrui/Mingrui/learning/arm_planning/ws_catkin/src/arm_planning/src/robot.cpp", "C++", 0, 0, 245, 28, 94, 367
"/home/mingrui/Mingrui/learning/arm_planning/ws_catkin/src/arm_planning/src/scene.cpp", "C++", 0, 0, 47, 5, 23, 75
"/home/mingrui/Mingrui/learning/arm_planning/ws_catkin/src/arm_planning/src/visualize.cpp", "C++", 0, 0, 74, 9, 33, 116
"Total", "-", 76, 58, 3087, 283, 1161, 4665